15.ox
.......o....
.o..........
............
.o..........
..o.ooo.....
.........o..
....o.......
......o.....
............
............
o...........
....oo.oo...
...........o
.oo.........
.....o......
